------###
------#.#
--#####.#####
-##         ##
##  # # # #  ##
#  ##     ##  #
# ##  # #  ## #
#     $@$     #
####  ###  ####
---#### ####