 ######
 # .  ##
##$  $@#
#  .#  #
#   #  #
########